WE textures/bird.xpm
EA textures/cat.xpm
SO textures/gorilla.xpm
NO textures/wolf.xpm

F 91,64,94
C 89,145,211

11111111111111111111111111111111111111111111111111111111
100000S00000000000000000000000000000000000000000000000001
10000000000000000000000001111111111111111111111111111111111
100000000000000000000000000000000000000000000000000000001
10000000000000000000000001111111111111111111111111111111111
100000000000000000000000000000000000000000000000000000001
10000000000000000000000001111111111111111111111111111111111
100000000000100000000000000000000000000000000000000000001
10000000000000000000000001111111111111111111111111111111111
100000000000000000000000000000000000000000000000000000001
10000000000010000000000001111111111111111111111111111111111
100000000000000000000000000000000000000000000000000000001
10000000000000000000000001111111111111111111111111111111111
1000000000000000000000000000000000000000000000000000001
100000000000000000000000011111111111111111111111111111
100000000000000000000000000000000000000000000001
10000000000000000000000001111111111111111111111
1111111111111111111111111
